18 12

2,2,2,2,2,2,23,23,23,23,23,23,23,2,2,2,2,2,
2,2,21,2,23,23,23,2,2,2,2,21,2,2,23,2,2,2,
4,11,2,23,23,2,2,2,21,2,2,2,2,23,23,2,2,2,
2,3,2,23,2,10,4,4,4,4,4,11,2,2,23,23,2,2,
2,3,2,2,10,13,2,2,2,2,21,12,11,21,2,23,2,2,
2,3,2,10,13,2,2,2,23,23,23,2,3,2,2,23,2,2,
2,12,4,13,2,2,23,23,23,2,2,10,13,2,2,23,2,2,
2,2,2,2,2,23,23,2,2,10,4,13,2,2,23,2,2,2,
2,2,2,2,23,23,2,2,10,13,2,2,2,23,23,2,2,2,
2,22,2,2,23,2,2,10,13,2,21,2,23,23,2,2,2,2,
2,2,2,2,23,2,10,13,2,2,2,23,23,2,2,2,2,2,
2,2,2,2,23,2,15,2,23,23,23,23,2,2,2,2,2,2,

0,0,0,0,0,0,0,0,0,0,0,0,0,21,54,0,0,0,
0,0,0,0,0,0,0,0,0,0,0,0,0,0,0,54,0,0,
0,0,0,0,0,0,0,0,0,0,0,0,0,0,0,54,0,0,
0,0,0,0,0,0,0,0,0,0,0,0,0,0,0,0,0,0,
0,0,0,0,0,0,0,0,0,0,0,0,0,0,0,0,0,0,
0,0,52,0,0,0,0,55,0,0,0,0,0,0,55,0,0,52,
0,0,0,0,0,0,0,0,0,0,0,0,0,0,0,0,0,0,
48,0,0,0,0,0,0,0,0,0,0,0,0,53,0,23,0,0,
0,0,0,0,0,0,0,0,0,0,0,0,0,0,0,0,0,0,
0,0,0,0,0,38,0,0,0,0,0,0,0,0,0,0,0,0,
0,0,0,0,0,0,0,0,0,0,0,0,0,0,0,52,0,0,
0,0,0,0,0,42,0,0,0,0,0,0,0,0,0,0,0,54,

1, 1, 1,   1, 1, 1,   1, 1, 1,   1, 1, 1,   1, 1, 1,   1, 1, 1,   0, 0, 0,   0, 0, 0,   0, 0, 0,   0, 0, 0,   0, 0, 0,   0, 0, 0,   0, 0, 0,   0, 0, 1,   1, 1, 1,   1, 1, 1,   1, 1, 1,   1, 1, 1,   
1, 1, 1,   1, 1, 1,   1, 1, 1,   1, 1, 1,   1, 1, 1,   1, 1, 1,   0, 0, 0,   0, 0, 0,   0, 0, 0,   0, 0, 0,   0, 0, 0,   0, 0, 0,   0, 0, 0,   0, 0, 1,   1, 0, 1,   1, 1, 1,   1, 1, 1,   1, 1, 1,   
1, 1, 1,   1, 1, 1,   1, 1, 1,   1, 1, 1,   1, 1, 1,   1, 1, 1,   0, 0, 0,   0, 0, 0,   0, 0, 0,   0, 0, 0,   0, 0, 0,   0, 0, 0,   0, 0, 0,   1, 1, 1,   1, 1, 1,   1, 1, 1,   1, 1, 1,   1, 1, 1,   

1, 1, 1,   1, 1, 1,   0, 0, 1,   1, 1, 1,   0, 0, 0,   0, 0, 0,   0, 0, 0,   1, 1, 1,   1, 1, 1,   1, 1, 1,   1, 1, 1,   0, 0, 1,   1, 1, 1,   1, 1, 1,   0, 0, 0,   1, 1, 1,   1, 1, 1,   1, 1, 1,   
1, 1, 1,   1, 1, 1,   0, 0, 1,   1, 1, 1,   0, 0, 0,   0, 0, 0,   0, 0, 0,   1, 1, 1,   1, 1, 1,   1, 1, 1,   1, 1, 1,   0, 0, 1,   1, 1, 1,   1, 1, 1,   0, 0, 0,   1, 0, 1,   1, 1, 1,   1, 1, 1,   
1, 1, 1,   1, 1, 1,   1, 1, 1,   1, 1, 1,   0, 0, 0,   0, 0, 0,   0, 0, 0,   1, 1, 1,   1, 1, 1,   1, 1, 1,   1, 1, 1,   1, 1, 1,   1, 1, 1,   1, 1, 1,   0, 0, 0,   1, 1, 1,   1, 1, 1,   1, 1, 1,   

2, 1, 1,   1, 1, 1,   1, 1, 1,   0, 0, 0,   0, 0, 0,   1, 1, 1,   1, 1, 1,   1, 1, 1,   0, 0, 1,   1, 1, 1,   1, 1, 1,   1, 1, 1,   1, 1, 1,   0, 0, 0,   0, 0, 0,   1, 1, 1,   1, 1, 1,   1, 1, 1,   
2, 1, 1,   1, 1, 1,   1, 1, 1,   0, 0, 0,   0, 0, 0,   1, 1, 1,   1, 1, 1,   1, 1, 1,   0, 0, 1,   1, 1, 1,   1, 1, 1,   1, 1, 1,   1, 1, 1,   0, 0, 0,   0, 0, 0,   1, 0, 1,   1, 1, 1,   1, 1, 1,   
2, 1, 1,   1, 1, 1,   1, 1, 1,   0, 0, 0,   0, 0, 0,   1, 1, 1,   1, 1, 1,   1, 1, 1,   1, 1, 1,   1, 1, 1,   1, 1, 1,   1, 1, 1,   1, 1, 1,   0, 0, 0,   0, 0, 0,   1, 1, 1,   1, 1, 1,   1, 1, 1,   

1, 1, 1,   1, 1, 1,   1, 1, 1,   0, 0, 0,   1, 1, 1,   1, 1, 1,   1, 1, 1,   1, 1, 1,   1, 1, 1,   1, 1, 1,   1, 1, 1,   1, 1, 1,   1, 1, 1,   1, 1, 1,   0, 0, 0,   0, 0, 0,   1, 1, 1,   1, 1, 1,   
1, 1, 1,   1, 1, 1,   1, 1, 1,   0, 0, 0,   1, 1, 1,   1, 1, 1,   1, 1, 1,   1, 1, 1,   1, 1, 1,   1, 1, 1,   1, 1, 1,   1, 1, 1,   1, 1, 1,   1, 1, 1,   0, 0, 0,   0, 0, 0,   1, 1, 1,   1, 1, 1,   
1, 1, 1,   1, 1, 1,   1, 1, 1,   0, 0, 0,   1, 1, 1,   1, 1, 1,   1, 1, 1,   1, 1, 1,   1, 1, 1,   1, 1, 1,   1, 1, 1,   1, 1, 1,   1, 1, 1,   1, 1, 1,   0, 0, 0,   0, 0, 0,   1, 1, 1,   1, 1, 1,   

1, 1, 1,   1, 1, 1,   1, 1, 1,   1, 1, 1,   1, 1, 1,   1, 1, 1,   1, 1, 1,   1, 1, 1,   1, 1, 1,   1, 1, 1,   0, 0, 1,   1, 1, 1,   1, 1, 1,   0, 0, 1,   1, 1, 1,   0, 0, 0,   1, 1, 1,   1, 1, 1,   
1, 1, 1,   1, 1, 1,   1, 1, 1,   1, 1, 1,   1, 1, 1,   1, 1, 1,   1, 1, 1,   1, 1, 1,   1, 1, 1,   1, 1, 1,   0, 0, 1,   1, 1, 1,   1, 1, 1,   0, 0, 1,   1, 1, 1,   0, 0, 0,   1, 1, 1,   1, 1, 1,   
1, 1, 1,   1, 1, 1,   1, 1, 1,   1, 1, 1,   1, 1, 1,   1, 1, 1,   1, 1, 1,   1, 1, 1,   1, 1, 1,   1, 1, 1,   1, 1, 1,   1, 1, 1,   1, 1, 1,   1, 1, 1,   1, 1, 1,   0, 0, 0,   1, 1, 1,   1, 1, 1,   

1, 1, 1,   1, 1, 1,   0, 0, 0,   1, 1, 1,   1, 1, 1,   1, 1, 1,   1, 1, 1,   1, 1, 1,   0, 0, 0,   0, 0, 0,   0, 0, 0,   1, 1, 1,   1, 1, 1,   1, 1, 1,   1, 1, 1,   0, 0, 0,   1, 1, 1,   0, 0, 0,   
1, 1, 1,   1, 1, 1,   0, 0, 0,   1, 1, 1,   1, 1, 1,   1, 1, 1,   1, 1, 1,   1, 0, 1,   0, 0, 0,   0, 0, 0,   0, 0, 0,   1, 1, 1,   1, 1, 1,   1, 1, 1,   1, 0, 1,   0, 0, 0,   1, 1, 1,   0, 0, 0,   
1, 1, 1,   1, 1, 1,   0, 0, 0,   1, 1, 1,   1, 1, 1,   1, 1, 1,   1, 1, 1,   1, 1, 1,   0, 0, 0,   0, 0, 0,   0, 0, 0,   1, 1, 1,   1, 1, 1,   1, 1, 1,   1, 1, 1,   0, 0, 0,   1, 1, 1,   0, 0, 0,   

1, 1, 1,   1, 1, 1,   1, 1, 1,   1, 1, 1,   1, 1, 1,   1, 1, 1,   0, 0, 0,   0, 0, 0,   0, 0, 0,   1, 1, 1,   1, 1, 1,   1, 1, 1,   1, 1, 1,   1, 1, 1,   1, 1, 1,   0, 0, 0,   1, 1, 1,   1, 1, 1,   
1, 1, 1,   1, 1, 1,   1, 1, 1,   1, 1, 1,   1, 1, 1,   1, 1, 1,   0, 0, 0,   0, 0, 0,   0, 0, 0,   1, 1, 1,   1, 1, 1,   1, 1, 1,   1, 1, 1,   1, 1, 1,   1, 1, 1,   0, 0, 0,   1, 1, 1,   1, 1, 1,   
1, 1, 1,   1, 1, 1,   1, 1, 1,   1, 1, 1,   1, 1, 1,   1, 1, 1,   0, 0, 0,   0, 0, 0,   0, 0, 0,   1, 1, 1,   1, 1, 1,   1, 1, 1,   1, 1, 1,   1, 1, 1,   1, 1, 1,   0, 0, 0,   1, 1, 1,   1, 1, 1,   

1, 1, 1,   1, 1, 1,   1, 1, 1,   1, 1, 1,   1, 1, 1,   0, 0, 0,   0, 0, 0,   1, 1, 1,   1, 1, 1,   1, 1, 1,   1, 1, 1,   1, 1, 1,   1, 1, 1,   1, 1, 1,   0, 0, 0,   0, 0, 0,   1, 1, 1,   1, 1, 1,   
1, 0, 1,   1, 1, 1,   1, 1, 1,   1, 1, 1,   1, 1, 1,   0, 0, 0,   0, 0, 0,   1, 1, 1,   1, 1, 1,   1, 1, 1,   1, 1, 1,   1, 1, 1,   1, 1, 1,   0, 0, 0,   0, 0, 0,   0, 0, 0,   1, 1, 1,   1, 1, 1,   
1, 1, 1,   1, 1, 1,   1, 1, 1,   1, 1, 1,   1, 1, 1,   0, 0, 0,   0, 0, 0,   1, 1, 1,   1, 1, 1,   1, 1, 1,   1, 1, 1,   1, 1, 1,   1, 1, 1,   1, 1, 1,   0, 0, 0,   0, 0, 0,   1, 1, 1,   1, 1, 1,   

1, 1, 1,   1, 1, 1,   1, 1, 1,   1, 1, 1,   0, 0, 0,   0, 0, 0,   1, 1, 1,   1, 1, 1,   1, 1, 1,   1, 1, 1,   1, 1, 1,   1, 1, 1,   1, 1, 1,   0, 0, 0,   0, 0, 0,   1, 1, 1,   1, 1, 1,   1, 1, 1,   
1, 1, 1,   1, 1, 1,   1, 1, 1,   1, 1, 1,   0, 0, 0,   0, 0, 0,   1, 1, 1,   1, 1, 1,   1, 1, 1,   1, 1, 1,   1, 1, 1,   1, 1, 1,   1, 1, 1,   0, 0, 0,   0, 0, 0,   1, 1, 1,   1, 1, 1,   1, 1, 1,   
1, 1, 1,   1, 1, 1,   1, 1, 1,   1, 1, 1,   0, 0, 0,   0, 0, 0,   1, 1, 1,   1, 1, 1,   1, 1, 1,   1, 1, 1,   1, 1, 1,   1, 1, 1,   1, 1, 1,   0, 0, 0,   0, 0, 0,   1, 1, 1,   1, 1, 1,   1, 1, 1,   

1, 1, 1,   1, 0, 0,   1, 1, 1,   1, 1, 1,   0, 0, 0,   0, 0, 0,   1, 1, 1,   1, 1, 1,   1, 1, 1,   1, 1, 1,   0, 0, 1,   1, 1, 1,   0, 0, 0,   0, 0, 0,   1, 1, 1,   1, 1, 1,   1, 1, 1,   1, 1, 1,   
1, 1, 1,   0, 0, 0,   1, 1, 1,   1, 1, 1,   0, 0, 0,   0, 0, 0,   1, 1, 1,   1, 1, 1,   1, 1, 1,   1, 1, 1,   0, 0, 1,   1, 1, 1,   0, 0, 0,   0, 0, 0,   1, 1, 1,   1, 1, 1,   1, 1, 1,   1, 1, 1,   
1, 1, 1,   0, 0, 0,   1, 1, 1,   1, 1, 1,   0, 0, 0,   0, 2, 0,   1, 1, 1,   1, 1, 1,   1, 1, 1,   1, 1, 1,   1, 1, 1,   1, 1, 1,   0, 0, 0,   0, 0, 0,   1, 1, 1,   1, 1, 1,   1, 1, 1,   1, 1, 1,   

1, 1, 1,   1, 1, 1,   1, 1, 1,   1, 1, 1,   0, 0, 0,   1, 1, 1,   1, 1, 1,   1, 1, 1,   1, 1, 1,   1, 1, 1,   1, 1, 1,   0, 0, 0,   0, 0, 0,   1, 1, 1,   1, 1, 1,   0, 0, 0,   1, 1, 1,   1, 1, 1,   
1, 1, 1,   1, 1, 1,   1, 1, 1,   1, 1, 1,   0, 0, 0,   1, 1, 1,   1, 1, 1,   1, 1, 1,   1, 1, 1,   1, 1, 1,   1, 1, 1,   0, 0, 0,   0, 0, 0,   1, 1, 1,   1, 1, 1,   0, 0, 0,   1, 1, 1,   1, 1, 1,   
1, 1, 1,   1, 1, 1,   1, 1, 1,   1, 1, 1,   0, 0, 0,   1, 1, 1,   1, 1, 1,   1, 1, 1,   1, 1, 1,   1, 1, 1,   1, 1, 1,   0, 0, 0,   0, 0, 0,   1, 1, 1,   1, 1, 1,   0, 0, 0,   1, 1, 1,   1, 1, 1,   

1, 1, 1,   1, 1, 1,   1, 1, 1,   1, 1, 1,   0, 0, 0,   1, 1, 1,   1, 1, 1,   1, 1, 1,   0, 0, 0,   0, 0, 0,   0, 0, 0,   0, 0, 0,   1, 1, 1,   1, 1, 1,   1, 1, 1,   1, 1, 1,   1, 1, 1,   1, 1, 1,   
1, 1, 1,   1, 1, 1,   1, 1, 1,   1, 1, 1,   0, 0, 0,   1, 0, 1,   1, 1, 1,   1, 1, 1,   0, 0, 0,   0, 0, 0,   0, 0, 0,   0, 0, 0,   1, 1, 1,   1, 1, 1,   1, 1, 1,   1, 1, 1,   1, 1, 1,   1, 0, 1,   
1, 1, 1,   1, 1, 1,   1, 1, 1,   1, 1, 1,   0, 0, 0,   1, 0, 1,   1, 1, 1,   1, 1, 1,   0, 0, 0,   0, 0, 0,   0, 0, 0,   0, 0, 0,   1, 1, 1,   1, 1, 1,   1, 1, 1,   1, 1, 1,   1, 1, 1,   1, 1, 1,   

5

13 15 
orkSword
4
19 10
pirate
5
30 10
orkSword
4
37 19
pitare
5
25 27
orkSword
4

2

0 2
3
1 4 7
52 25
map_1

5 9
1
8
7 16
map_5

