18 12

30,30,30,30,27,27,27,23,23,23,23,23,23,23,2,3,2,2,
30,30,30,27,27,27,2,26,23,23,23,23,23,2,2,3,2,2,
30,30,30,27,27,2,26,26,2,2,2,2,2,2,10,7,4,11,
30,30,27,27,27,2,2,2,2,2,2,2,2,2,3,2,2,15,
30,30,27,27,2,2,2,2,2,2,2,2,2,2,3,2,2,2,
30,30,27,27,2,2,2,2,2,2,2,2,2,10,13,2,2,2,
30,30,27,27,2,2,2,2,2,2,2,2,2,3,2,2,2,2,
30,30,27,27,2,2,2,2,2,2,2,2,10,7,4,4,11,2,
30,30,27,27,2,2,16,2,16,2,2,2,3,2,2,20,12,4,
30,30,27,27,27,2,12,11,3,16,16,2,3,2,20,20,20,2,
30,30,27,27,27,2,2,12,7,7,7,4,13,20,20,20,20,20,
30,30,30,27,27,2,2,2,2,2,2,2,20,20,20,20,20,20,

0,0,0,0,0,0,0,0,0,0,0,0,0,0,0,0,0,0,
0,0,0,0,0,0,0,0,0,0,0,0,0,0,0,0,0,0,
0,0,0,0,0,0,0,0,53,0,0,0,0,0,0,0,0,0,
0,0,0,0,0,0,0,47,42,0,0,47,0,0,0,0,0,0,
0,0,0,0,0,0,0,0,0,0,0,0,0,0,0,0,0,0,
0,0,0,0,0,0,0,0,0,0,0,47,0,0,0,0,0,0,
0,0,0,0,0,0,0,0,0,0,0,0,0,0,0,0,0,0,
0,0,0,0,0,0,32,0,0,0,0,0,0,0,0,0,0,0,
0,0,0,0,0,0,33,0,41,0,0,0,0,0,0,0,0,0,
0,0,0,0,0,31,0,0,0,41,41,0,0,0,0,0,0,0,
0,0,0,0,0,0,0,0,0,0,0,0,0,0,0,0,0,0,
0,0,0,0,0,0,0,0,0,47,0,0,0,0,0,0,0,0,

0, 0, 0,   0, 0, 0,   0, 0, 0,   0, 0, 0,   1, 1, 1,   1, 1, 1,   1, 1, 1,   0, 0, 0,   0, 0, 0,   0, 0, 0,   0, 0, 0,   0, 0, 0,   0, 0, 0,   0, 0, 0,   1, 1, 1,   2, 2, 2,   1, 1, 1,   1, 1, 1,
0, 0, 0,   0, 0, 0,   0, 0, 0,   0, 0, 0,   1, 1, 1,   1, 1, 1,   1, 1, 1,   0, 0, 0,   0, 0, 0,   0, 0, 0,   0, 0, 0,   0, 0, 0,   0, 0, 0,   0, 0, 0,   1, 1, 1,   2, 2, 2,   1, 1, 1,   1, 1, 1,
0, 0, 0,   0, 0, 0,   0, 0, 0,   0, 0, 0,   1, 1, 1,   1, 1, 1,   1, 1, 1,   0, 0, 0,   0, 0, 0,   0, 0, 0,   0, 0, 0,   0, 0, 0,   0, 0, 0,   0, 0, 0,   1, 1, 1,   2, 2, 2,   1, 1, 1,   1, 1, 1,

0, 0, 0,   0, 0, 0,   0, 0, 0,   1, 1, 1,   1, 1, 1,   1, 1, 1,   1, 1, 1,   0, 0, 0,   0, 0, 0,   0, 0, 0,   0, 0, 0,   0, 0, 0,   0, 0, 0,   1, 1, 1,   1, 1, 1,   1, 1, 1,   1, 1, 1,   1, 1, 1,
0, 0, 0,   0, 0, 0,   0, 0, 0,   1, 1, 1,   1, 1, 1,   1, 1, 1,   1, 1, 1,   0, 0, 0,   0, 0, 0,   0, 0, 0,   0, 0, 0,   0, 0, 0,   0, 0, 0,   1, 1, 1,   1, 1, 1,   1, 1, 1,   1, 1, 1,   1, 1, 1,
0, 0, 0,   0, 0, 0,   0, 0, 0,   1, 1, 1,   1, 1, 1,   1, 1, 1,   1, 1, 1,   0, 0, 0,   0, 0, 0,   0, 0, 0,   0, 0, 0,   0, 0, 0,   0, 0, 0,   1, 1, 1,   1, 1, 1,   1, 1, 1,   1, 1, 1,   1, 1, 1,

0, 0, 0,   0, 0, 0,   0, 0, 0,   1, 1, 1,   1, 1, 1,   1, 1, 1,   0, 0, 0,   0, 0, 0,   1, 1, 1,   1, 1, 1,   1, 1, 1,   1, 1, 1,   1, 1, 1,   1, 1, 1,   1, 1, 1,   1, 1, 1,   1, 1, 1,   1, 1, 1,
0, 0, 0,   0, 0, 0,   0, 0, 0,   1, 1, 1,   1, 1, 1,   1, 1, 1,   0, 0, 0,   0, 0, 0,   0, 0, 0,   1, 1, 1,   1, 1, 1,   1, 1, 1,   1, 1, 1,   1, 1, 1,   1, 1, 1,   1, 1, 1,   1, 1, 1,   1, 1, 1,
0, 0, 0,   0, 0, 0,   0, 0, 0,   1, 1, 1,   1, 1, 1,   1, 1, 1,   0, 0, 0,   0, 0, 0,   1, 1, 1,   1, 1, 1,   1, 1, 1,   1, 1, 1,   1, 1, 1,   1, 1, 1,   1, 1, 1,   1, 1, 1,   1, 1, 1,   1, 1, 1,

0, 0, 0,   0, 0, 0,   1, 1, 1,   1, 1, 1,   1, 1, 1,   1, 1, 1,   1, 1, 1,   0, 0, 0,   1, 0, 1,   1, 1, 1,   1, 1, 1,   0, 0, 0,   1, 1, 1,   1, 1, 1,   1, 1, 1,   1, 1, 1,   1, 1, 1,   1, 1, 1,
0, 0, 0,   0, 0, 0,   1, 1, 1,   1, 1, 1,   1, 1, 1,   1, 1, 1,   1, 1, 1,   0, 0, 0,   1, 0, 1,   1, 1, 1,   1, 1, 1,   0, 0, 0,   1, 1, 1,   1, 1, 1,   1, 1, 1,   1, 1, 1,   1, 1, 1,   1, 1, 1,
0, 0, 0,   0, 0, 0,   1, 1, 1,   1, 1, 1,   1, 1, 1,   1, 1, 1,   1, 1, 1,   0, 0, 0,   1, 1, 1,   1, 1, 1,   1, 1, 1,   0, 0, 0,   1, 1, 1,   1, 1, 1,   1, 1, 1,   1, 1, 1,   1, 1, 1,   1, 1, 1,

0, 0, 0,   0, 0, 0,   1, 1, 1,   1, 1, 1,   1, 1, 1,   1, 1, 1,   1, 1, 1,   1, 1, 1,   1, 1, 1,   1, 1, 1,   1, 1, 1,   1, 1, 1,   1, 1, 1,   1, 1, 1,   1, 1, 1,   1, 1, 1,   1, 1, 1,   1, 1, 1,
0, 0, 0,   0, 0, 0,   1, 1, 1,   1, 1, 1,   1, 1, 1,   1, 1, 1,   1, 1, 1,   1, 1, 1,   1, 1, 1,   1, 1, 1,   1, 1, 1,   1, 1, 1,   1, 1, 1,   1, 1, 1,   1, 1, 1,   1, 1, 1,   1, 1, 1,   1, 1, 1,
0, 0, 0,   0, 0, 0,   1, 1, 1,   1, 1, 1,   1, 1, 1,   1, 1, 1,   1, 1, 1,   1, 1, 1,   1, 1, 1,   1, 1, 1,   1, 1, 1,   1, 1, 1,   1, 1, 1,   1, 1, 1,   1, 1, 1,   1, 1, 1,   1, 1, 1,   1, 1, 1,

0, 0, 0,   0, 0, 0,   1, 1, 1,   1, 1, 1,   1, 1, 1,   1, 1, 1,   1, 1, 1,   1, 1, 1,   1, 1, 1,   1, 1, 1,   1, 1, 1,   0, 0, 0,   1, 1, 1,   1, 1, 1,   1, 1, 1,   1, 1, 1,   1, 1, 1,   1, 1, 1,
0, 0, 0,   0, 0, 0,   1, 1, 1,   1, 1, 1,   1, 1, 1,   1, 1, 1,   1, 1, 1,   1, 1, 1,   1, 1, 1,   1, 1, 1,   1, 1, 1,   0, 0, 0,   1, 1, 1,   1, 1, 1,   1, 1, 1,   1, 1, 1,   1, 1, 1,   1, 1, 1,
0, 0, 0,   0, 0, 0,   1, 1, 1,   1, 1, 1,   1, 1, 1,   1, 1, 1,   1, 1, 1,   1, 1, 1,   1, 1, 1,   1, 1, 1,   1, 1, 1,   0, 0, 0,   1, 1, 1,   1, 1, 1,   1, 1, 1,   1, 1, 1,   1, 1, 1,   1, 1, 1,

0, 0, 0,   0, 0, 0,   1, 1, 1,   1, 1, 1,   1, 1, 1,   1, 1, 1,   1, 1, 1,   1, 1, 1,   1, 1, 1,   1, 1, 1,   1, 1, 1,   1, 1, 1,   1, 1, 1,   1, 1, 1,   1, 1, 1,   1, 1, 1,   1, 1, 1,   1, 1, 1,
0, 0, 0,   0, 0, 0,   1, 1, 1,   1, 1, 1,   1, 1, 1,   1, 1, 1,   1, 1, 1,   1, 1, 1,   1, 1, 1,   1, 1, 1,   1, 1, 1,   1, 1, 1,   1, 1, 1,   1, 1, 1,   1, 1, 1,   1, 1, 1,   1, 1, 1,   1, 1, 1,
0, 0, 0,   0, 0, 0,   1, 1, 1,   1, 1, 1,   1, 1, 1,   1, 1, 1,   1, 1, 1,   1, 1, 1,   1, 1, 1,   1, 1, 1,   1, 1, 1,   1, 1, 1,   1, 1, 1,   1, 1, 1,   1, 1, 1,   1, 1, 1,   1, 1, 1,   1, 1, 1,

0, 0, 0,   0, 0, 0,   1, 1, 1,   1, 1, 1,   1, 1, 1,   1, 1, 1,   1, 1, 1,   1, 1, 1,   1, 1, 1,   1, 1, 1,   1, 1, 1,   1, 1, 1,   1, 1, 1,   1, 1, 1,   1, 1, 1,   1, 1, 1,   1, 1, 1,   1, 1, 1,
0, 0, 0,   0, 0, 0,   1, 1, 1,   1, 1, 1,   1, 1, 1,   1, 1, 1,   0, 0, 0,   1, 1, 1,   1, 1, 1,   1, 1, 1,   1, 1, 1,   1, 1, 1,   1, 1, 1,   1, 1, 1,   1, 1, 1,   1, 1, 1,   1, 1, 1,   1, 1, 1,
0, 0, 0,   0, 0, 0,   1, 1, 1,   1, 1, 1,   1, 1, 1,   1, 1, 1,   0, 0, 0,   1, 1, 1,   1, 1, 1,   1, 1, 1,   1, 1, 1,   1, 1, 1,   1, 1, 1,   1, 1, 1,   1, 1, 1,   1, 1, 1,   1, 1, 1,   1, 1, 1,

0, 0, 0,   0, 0, 0,   1, 1, 1,   1, 1, 1,   1, 1, 1,   1, 1, 1,   0, 0, 0,   1, 1, 1,   0, 0, 0,   1, 1, 1,   1, 1, 1,   1, 1, 1,   1, 1, 1,   1, 1, 1,   1, 1, 1,   0, 0, 0,   1, 1, 1,   1, 1, 2,
0, 0, 0,   0, 0, 0,   1, 1, 1,   1, 1, 1,   1, 1, 1,   1, 1, 1,   0, 0, 0,   1, 1, 1,   0, 0, 0,   1, 1, 1,   1, 1, 1,   1, 1, 1,   1, 1, 1,   1, 1, 1,   1, 1, 1,   0, 0, 0,   1, 1, 1,   1, 1, 2,
0, 0, 0,   0, 0, 0,   1, 1, 1,   1, 1, 1,   1, 1, 1,   1, 1, 1,   1, 1, 1,   1, 1, 1,   0, 1, 0,   1, 1, 1,   1, 1, 1,   1, 1, 1,   1, 1, 1,   1, 1, 1,   1, 1, 1,   0, 0, 0,   1, 1, 1,   1, 1, 2,

0, 0, 0,   0, 0, 0,   1, 1, 1,   1, 1, 1,   1, 1, 1,   0, 0, 0,   1, 1, 1,   1, 1, 1,   1, 1, 1,   0, 0, 0,   0, 0, 0,   1, 1, 1,   1, 1, 1,   1, 1, 1,   0, 0, 0,   0, 0, 0,   0, 0, 0,   1, 1, 1,
0, 0, 0,   0, 0, 0,   1, 1, 1,   1, 1, 1,   1, 1, 1,   0, 0, 0,   1, 1, 1,   1, 1, 1,   1, 1, 1,   0, 0, 0,   0, 0, 0,   1, 1, 1,   1, 1, 1,   1, 1, 1,   0, 0, 0,   0, 0, 0,   0, 0, 0,   1, 1, 1,
0, 0, 0,   0, 0, 0,   1, 1, 1,   1, 1, 1,   1, 1, 1,   0, 0, 0,   1, 1, 1,   1, 1, 1,   1, 1, 1,   0, 1, 0,   0, 1, 0,   1, 1, 1,   1, 1, 1,   1, 1, 1,   0, 0, 0,   0, 0, 0,   0, 0, 0,   1, 1, 1,

0, 0, 0,   0, 0, 0,   1, 1, 1,   1, 1, 1,   1, 1, 1,   1, 1, 1,   1, 1, 1,   1, 1, 1,   1, 1, 1,   1, 1, 1,   1, 1, 1,   1, 1, 1,   1, 1, 1,   0, 0, 0,   0, 0, 0,   0, 0, 0,   0, 0, 0,   0, 0, 0,
0, 0, 0,   0, 0, 0,   1, 1, 1,   1, 1, 1,   1, 1, 1,   1, 1, 1,   1, 1, 1,   1, 1, 1,   1, 1, 1,   1, 1, 1,   1, 1, 1,   1, 1, 1,   1, 1, 1,   0, 0, 0,   0, 0, 0,   0, 0, 0,   0, 0, 0,   0, 0, 0,
0, 0, 0,   0, 0, 0,   1, 1, 1,   1, 1, 1,   1, 1, 1,   1, 1, 1,   1, 1, 1,   1, 1, 1,   1, 1, 1,   1, 1, 1,   1, 1, 1,   1, 1, 1,   1, 1, 1,   0, 0, 0,   0, 0, 0,   0, 0, 0,   0, 0, 0,   0, 0, 0,

0, 0, 0,   0, 0, 0,   0, 0, 0,   1, 1, 1,   1, 1, 1,   1, 1, 1,   1, 1, 1,   1, 1, 1,   1, 1, 1,   0, 0, 0,   1, 1, 1,   1, 1, 1,   0, 0, 0,   0, 0, 0,   0, 0, 0,   0, 0, 0,   0, 0, 0,   0, 0, 0,
0, 0, 0,   0, 0, 0,   0, 0, 0,   1, 1, 1,   1, 1, 1,   1, 1, 1,   1, 1, 1,   1, 1, 1,   1, 1, 1,   0, 0, 0,   1, 1, 1,   1, 1, 1,   0, 0, 0,   0, 0, 0,   0, 0, 0,   0, 0, 0,   0, 0, 0,   0, 0, 0,
0, 0, 0,   0, 0, 0,   0, 0, 0,   1, 1, 1,   1, 1, 1,   1, 1, 1,   1, 1, 1,   1, 1, 1,   1, 1, 1,   0, 0, 0,   1, 1, 1,   1, 1, 1,   0, 0, 0,   0, 0, 0,   0, 0, 0,   0, 0, 0,   0, 0, 0,   0, 0, 0,

4

24 8
orkSword
4
16 14
pirate
5
44 22
assassin
0
46 22
assassin
0

2


15 0
3
1 2 3
10 34
map_2


17 8
3
3 6 9
1 7
map_3