18 12

1,1,1,1,1,1,1,1,1,1,1,1,1,1,1,1,1,1,
1,27,27,27,27,27,27,27,27,27,27,27,27,1,27,27,27,1,
1,27,27,27,27,27,27,27,27,27,27,27,27,1,27,27,27,1,
1,1,27,1,1,27,27,27,27,27,27,27,27,1,27,27,27,1,
1,1,1,1,27,27,27,27,27,27,27,27,27,1,1,1,27,1,
1,1,27,27,27,27,27,1,27,27,27,27,27,27,27,27,27,1,
1,27,27,27,27,27,27,1,1,1,27,27,27,27,27,27,27,1,
1,27,1,1,1,1,27,27,27,1,1,1,27,27,27,27,27,1,
1,1,1,1,1,27,27,27,27,27,27,1,1,27,27,27,27,1,
1,27,27,27,27,27,27,27,27,27,27,27,27,27,27,27,27,1,
1,27,27,27,27,27,27,27,27,27,27,27,27,27,27,27,27,1,
1,1,1,1,1,1,1,1,27,1,1,1,1,1,1,1,1,1,

0,0,0,0,0,0,0,0,0,0,0,0,0,0,0,0,0,0,
0,0,0,0,0,44,0,0,0,0,0,0,0,0,0,0,43,0,
0,0,0,0,0,0,0,0,43,0,0,0,0,0,0,0,0,0,
0,0,0,0,0,0,0,0,0,0,0,0,0,0,0,0,0,0,
0,0,0,0,0,0,0,0,0,0,43,0,0,0,0,0,0,0,
0,0,0,0,0,0,0,0,0,0,0,0,0,0,0,0,0,0,
0,0,43,0,0,0,0,0,0,0,0,0,0,0,0,47,0,0,
0,0,0,0,0,0,0,0,0,0,0,0,0,0,0,0,0,0,
0,0,0,0,0,0,0,46,0,0,0,0,0,0,0,0,0,0,
0,0,0,0,0,0,0,0,0,0,0,0,0,0,0,0,0,0,
0,0,0,0,46,0,0,0,0,0,0,43,0,0,0,44,0,0,
0,0,0,0,0,0,0,0,0,0,0,0,0,0,0,0,0,0,

0, 0, 0,   0, 0, 0,   0, 0, 0,   0, 0, 0,   0, 0, 0,   0, 0, 0,   0, 0, 0,   0, 0, 0,   0, 0, 0,   0, 0, 0,   0, 0, 0,   0, 0, 0,   0, 0, 0,   0, 0, 0,   0, 0, 0,   0, 0, 0,   0, 0, 0,   0, 0, 0,   
0, 0, 0,   0, 0, 0,   0, 0, 0,   0, 0, 0,   0, 0, 0,   0, 0, 0,   0, 0, 0,   0, 0, 0,   0, 0, 0,   0, 0, 0,   0, 0, 0,   0, 0, 0,   0, 0, 0,   0, 0, 0,   0, 0, 0,   0, 0, 0,   0, 0, 0,   0, 0, 0,   
0, 0, 0,   0, 0, 0,   0, 0, 0,   0, 0, 0,   0, 0, 0,   0, 0, 0,   0, 0, 0,   0, 0, 0,   0, 0, 0,   0, 0, 0,   0, 0, 0,   0, 0, 0,   0, 0, 0,   0, 0, 0,   0, 0, 0,   0, 0, 0,   0, 0, 0,   0, 0, 0,   

0, 0, 0,   1, 1, 1,   1, 1, 1,   1, 1, 1,   1, 1, 1,   0, 0, 0,   1, 1, 1,   1, 1, 1,   1, 1, 1,   1, 1, 1,   1, 1, 1,   1, 1, 1,   1, 1, 1,   0, 0, 0,   1, 1, 1,   1, 1, 1,   1, 1, 1,   0, 0, 0,   
0, 0, 0,   1, 1, 1,   1, 1, 1,   1, 1, 1,   1, 1, 1,   0, 0, 0,   1, 1, 1,   1, 1, 1,   1, 1, 1,   1, 1, 1,   1, 1, 1,   1, 1, 1,   1, 1, 1,   0, 0, 0,   1, 1, 1,   1, 1, 1,   1, 0, 1,   0, 0, 0,   
0, 0, 0,   1, 1, 1,   1, 1, 1,   1, 1, 1,   1, 1, 1,   0, 0, 0,   1, 1, 1,   1, 1, 1,   1, 1, 1,   1, 1, 1,   1, 1, 1,   1, 1, 1,   1, 1, 1,   0, 0, 0,   1, 1, 1,   1, 1, 1,   1, 1, 1,   0, 0, 0,   

0, 0, 0,   1, 1, 1,   1, 1, 1,   1, 1, 1,   1, 1, 1,   1, 1, 1,   1, 1, 1,   1, 1, 1,   1, 1, 1,   1, 1, 1,   1, 1, 1,   1, 1, 1,   1, 1, 1,   0, 0, 0,   1, 1, 1,   1, 1, 1,   1, 1, 1,   0, 0, 0,   
0, 0, 0,   1, 1, 1,   1, 1, 1,   1, 1, 1,   1, 1, 1,   1, 1, 1,   1, 1, 1,   1, 1, 1,   1, 0, 1,   1, 1, 1,   1, 1, 1,   1, 1, 1,   1, 1, 1,   0, 0, 0,   1, 1, 1,   1, 1, 1,   1, 1, 1,   0, 0, 0,   
0, 0, 0,   1, 1, 1,   1, 1, 1,   1, 1, 1,   1, 1, 1,   1, 1, 1,   1, 1, 1,   1, 1, 1,   1, 1, 1,   1, 1, 1,   1, 1, 1,   1, 1, 1,   1, 1, 1,   0, 0, 0,   1, 1, 1,   1, 1, 1,   1, 1, 1,   0, 0, 0,   

0, 0, 0,   0, 0, 0,   1, 1, 1,   0, 0, 0,   0, 0, 0,   1, 1, 1,   1, 1, 1,   1, 1, 1,   1, 1, 1,   1, 1, 1,   1, 1, 1,   1, 1, 1,   1, 1, 1,   0, 0, 0,   1, 1, 1,   1, 1, 1,   1, 1, 1,   0, 0, 0,   
0, 0, 0,   0, 0, 0,   1, 1, 1,   0, 0, 0,   0, 0, 0,   1, 1, 1,   1, 1, 1,   1, 1, 1,   1, 1, 1,   1, 1, 1,   1, 1, 1,   1, 1, 1,   1, 1, 1,   0, 0, 0,   1, 1, 1,   1, 1, 1,   1, 1, 1,   0, 0, 0,   
0, 0, 0,   0, 0, 0,   1, 1, 1,   0, 0, 0,   0, 0, 0,   1, 1, 1,   1, 1, 1,   1, 1, 1,   1, 1, 1,   1, 1, 1,   1, 1, 1,   1, 1, 1,   1, 1, 1,   0, 0, 0,   1, 1, 1,   1, 1, 1,   1, 1, 1,   0, 0, 0,   

0, 0, 0,   0, 0, 0,   0, 0, 0,   0, 0, 0,   1, 1, 1,   1, 1, 1,   1, 1, 1,   1, 1, 1,   1, 1, 1,   1, 1, 1,   1, 1, 1,   1, 1, 1,   1, 1, 1,   0, 0, 0,   0, 0, 0,   0, 0, 0,   1, 1, 1,   0, 0, 0,   
0, 0, 0,   0, 0, 0,   0, 0, 0,   0, 0, 0,   1, 1, 1,   1, 1, 1,   1, 1, 1,   1, 1, 1,   1, 1, 1,   1, 1, 1,   1, 0, 1,   1, 1, 1,   1, 1, 1,   0, 0, 0,   0, 0, 0,   0, 0, 0,   1, 1, 1,   0, 0, 0,   
0, 0, 0,   0, 0, 0,   0, 0, 0,   0, 0, 0,   1, 1, 1,   1, 1, 1,   1, 1, 1,   1, 1, 1,   1, 1, 1,   1, 1, 1,   1, 1, 1,   1, 1, 1,   1, 1, 1,   0, 0, 0,   0, 0, 0,   0, 0, 0,   1, 1, 1,   0, 0, 0,   

0, 0, 0,   0, 0, 0,   1, 1, 1,   1, 1, 1,   1, 1, 1,   1, 1, 1,   1, 1, 1,   0, 0, 0,   1, 1, 1,   1, 1, 1,   1, 1, 1,   1, 1, 1,   1, 1, 1,   1, 1, 1,   1, 1, 1,   1, 1, 1,   1, 1, 1,   0, 0, 0,   
0, 0, 0,   0, 0, 0,   1, 1, 1,   1, 1, 1,   1, 1, 1,   1, 1, 1,   1, 1, 1,   0, 0, 0,   1, 1, 1,   1, 1, 1,   1, 1, 1,   1, 1, 1,   1, 1, 1,   1, 1, 1,   1, 1, 1,   1, 1, 1,   1, 1, 1,   0, 0, 0,   
0, 0, 0,   0, 0, 0,   1, 1, 1,   1, 1, 1,   1, 1, 1,   1, 1, 1,   1, 1, 1,   0, 0, 0,   1, 1, 1,   1, 1, 1,   1, 1, 1,   1, 1, 1,   1, 1, 1,   1, 1, 1,   1, 1, 1,   1, 1, 1,   1, 1, 1,   0, 0, 0,   

0, 0, 0,   1, 1, 1,   1, 1, 1,   1, 1, 1,   1, 1, 1,   1, 1, 1,   1, 1, 1,   0, 0, 0,   0, 0, 0,   0, 0, 0,   1, 1, 1,   1, 1, 1,   1, 1, 1,   1, 1, 1,   1, 1, 1,   0, 0, 0,   1, 1, 1,   0, 0, 0,   
0, 0, 0,   1, 1, 1,   1, 0, 1,   1, 1, 1,   1, 1, 1,   1, 1, 1,   1, 1, 1,   0, 0, 0,   0, 0, 0,   0, 0, 0,   1, 1, 1,   1, 1, 1,   1, 1, 1,   1, 1, 1,   1, 1, 1,   0, 0, 0,   1, 1, 1,   0, 0, 0,   
0, 0, 0,   1, 1, 1,   1, 1, 1,   1, 1, 1,   1, 1, 1,   1, 1, 1,   1, 1, 1,   0, 0, 0,   0, 0, 0,   0, 0, 0,   1, 1, 1,   1, 1, 1,   1, 1, 1,   1, 1, 1,   1, 1, 1,   0, 0, 0,   1, 1, 1,   0, 0, 0,   

0, 0, 0,   1, 1, 1,   0, 0, 0,   0, 0, 0,   0, 0, 0,   0, 0, 0,   1, 1, 1,   1, 1, 1,   1, 1, 1,   0, 0, 0,   0, 0, 0,   0, 0, 0,   1, 1, 1,   1, 1, 1,   1, 1, 1,   1, 1, 1,   1, 1, 1,   0, 0, 0,   
0, 0, 0,   1, 1, 1,   0, 0, 0,   0, 0, 0,   0, 0, 0,   0, 0, 0,   1, 1, 1,   1, 1, 1,   1, 1, 1,   0, 0, 0,   0, 0, 0,   0, 0, 0,   1, 1, 1,   1, 1, 1,   1, 1, 1,   1, 1, 1,   1, 1, 1,   0, 0, 0,   
0, 0, 0,   1, 1, 1,   0, 0, 0,   0, 0, 0,   0, 0, 0,   0, 0, 0,   1, 1, 1,   1, 1, 1,   1, 1, 1,   0, 0, 0,   0, 0, 0,   0, 0, 0,   1, 1, 1,   1, 1, 1,   1, 1, 1,   1, 1, 1,   1, 1, 1,   0, 0, 0,   

0, 0, 0,   0, 0, 0,   0, 0, 0,   0, 0, 0,   0, 0, 0,   1, 1, 1,   1, 1, 1,   0, 0, 0,   1, 1, 1,   1, 1, 1,   1, 1, 1,   0, 0, 0,   0, 0, 0,   1, 1, 1,   1, 1, 1,   1, 1, 1,   1, 1, 1,   0, 0, 0,   
0, 0, 0,   0, 0, 0,   0, 0, 0,   0, 0, 0,   0, 0, 0,   1, 1, 1,   1, 1, 1,   0, 0, 0,   1, 1, 1,   1, 1, 1,   1, 1, 1,   0, 0, 0,   0, 0, 0,   1, 1, 1,   1, 1, 1,   1, 1, 1,   1, 1, 1,   0, 0, 0,   
0, 0, 0,   0, 0, 0,   0, 0, 0,   0, 0, 0,   0, 0, 0,   1, 1, 1,   1, 1, 1,   0, 0, 0,   1, 1, 1,   1, 1, 1,   1, 1, 1,   0, 0, 0,   0, 0, 0,   1, 1, 1,   1, 1, 1,   1, 1, 1,   1, 1, 1,   0, 0, 0,   

0, 0, 0,   1, 1, 1,   1, 1, 1,   1, 1, 1,   1, 1, 1,   1, 1, 1,   1, 1, 1,   1, 1, 1,   1, 1, 1,   1, 1, 1,   1, 1, 1,   1, 1, 1,   1, 1, 1,   1, 1, 1,   1, 1, 1,   1, 1, 1,   1, 1, 1,   0, 0, 0,   
0, 0, 0,   1, 1, 1,   1, 1, 1,   1, 1, 1,   1, 1, 1,   1, 1, 1,   1, 1, 1,   1, 1, 1,   1, 1, 1,   1, 1, 1,   1, 1, 1,   1, 1, 1,   1, 1, 1,   1, 1, 1,   1, 1, 1,   1, 1, 1,   1, 1, 1,   0, 0, 0,   
0, 0, 0,   1, 1, 1,   1, 1, 1,   1, 1, 1,   1, 1, 1,   1, 1, 1,   1, 1, 1,   1, 1, 1,   1, 1, 1,   1, 1, 1,   1, 1, 1,   1, 1, 1,   1, 1, 1,   1, 1, 1,   1, 1, 1,   1, 1, 1,   1, 1, 1,   0, 0, 0,   

0, 0, 0,   1, 1, 1,   1, 1, 1,   1, 1, 1,   0, 0, 0,   1, 1, 1,   1, 1, 1,   1, 1, 1,   1, 1, 1,   1, 1, 1,   1, 1, 1,   1, 1, 1,   1, 1, 1,   1, 1, 1,   1, 1, 1,   0, 0, 0,   1, 1, 1,   0, 0, 0,   
0, 0, 0,   1, 1, 1,   1, 1, 1,   1, 1, 1,   0, 0, 0,   1, 1, 1,   1, 1, 1,   1, 1, 1,   1, 1, 1,   1, 1, 1,   1, 1, 1,   1, 0, 1,   1, 1, 1,   1, 1, 1,   1, 1, 1,   0, 0, 0,   1, 1, 1,   0, 0, 0,   
0, 0, 0,   1, 1, 1,   1, 1, 1,   1, 1, 1,   0, 0, 0,   1, 1, 1,   1, 1, 1,   1, 1, 1,   1, 1, 1,   1, 1, 1,   1, 1, 1,   1, 1, 1,   1, 1, 1,   1, 1, 1,   1, 1, 1,   0, 0, 0,   1, 1, 1,   0, 0, 0,   

0, 0, 0,   0, 0, 0,   0, 0, 0,   0, 0, 0,   0, 0, 0,   0, 0, 0,   0, 0, 0,   0, 0, 0,   1, 1, 1,   0, 0, 0,   0, 0, 0,   0, 0, 0,   0, 0, 0,   0, 0, 0,   0, 0, 0,   0, 0, 0,   0, 0, 0,   0, 0, 0,   
0, 0, 0,   0, 0, 0,   0, 0, 0,   0, 0, 0,   0, 0, 0,   0, 0, 0,   0, 0, 0,   0, 0, 0,   1, 1, 1,   0, 0, 0,   0, 0, 0,   0, 0, 0,   0, 0, 0,   0, 0, 0,   0, 0, 0,   0, 0, 0,   0, 0, 0,   0, 0, 0,   
0, 0, 0,   0, 0, 0,   0, 0, 0,   0, 0, 0,   0, 0, 0,   0, 0, 0,   0, 0, 0,   0, 0, 0,   2, 2, 2,   0, 0, 0,   0, 0, 0,   0, 0, 0,   0, 0, 0,   0, 0, 0,   0, 0, 0,   0, 0, 0,   0, 0, 0,   0, 0, 0,   


11

8 30
skeleton
6
15 29
skeleton
6
20 24
skeleton
6
16 18
skeleton
6
10 18
skeleton
6
18 10
skeleton
6
8 6
skeleton
6
32 8
skeleton
6
38 18
skeleton
6
45 25
skeleton
6
45 10
orkSpearShield
3

1

8 11
3
7 8 9
37 14
map_2





