18 12

2,2,2,2,2,3,2,2,2,2,2,2,21,19,23,23,20,20,
2,2,2,2,2,3,2,2,21,2,2,2,2,19,19,2,23,20,
2,2,2,2,2,3,16,2,16,2,2,2,2,2,2,2,22,22,
2,2,2,21,2,12,7,4,13,2,2,2,2,2,2,2,2,22,
2,2,2,2,2,2,2,18,2,2,2,2,16,2,16,2,2,2,
2,2,21,10,4,4,4,6,4,4,4,4,7,4,13,2,21,2,
20,2,2,3,2,2,2,12,11,18,2,16,16,16,2,2,2,2,
23,2,2,3,2,2,2,2,12,6,4,7,7,7,4,4,11,2,
20,23,18,3,2,2,2,2,2,3,2,16,16,16,2,2,15,2,
23,20,2,3,20,2,22,22,2,12,4,7,7,13,2,2,2,2,
20,23,21,3,20,22,23,23,22,2,2,2,2,2,2,2,21,2,
23,20,23,3,20,20,23,23,22,22,2,2,24,26,26,25,2,2,

0,0,54,54,0,0,0,0,0,0,0,48,0,0,0,0,0,0,
55,0,0,44,0,0,0,0,0,0,0,0,0,0,0,48,0,0,
55,44,0,0,0,0,41,0,41,0,0,0,0,0,0,0,0,0,
55,0,0,0,0,0,0,0,0,0,0,0,34,0,36,0,0,0,
0,0,0,0,0,0,0,0,0,0,0,0,35,0,37,0,0,0,
0,0,0,0,0,0,0,0,0,0,0,0,0,0,0,0,0,0,
0,0,0,0,0,0,0,0,0,0,0,39,39,39,0,0,0,0,
0,0,49,0,0,0,0,0,0,0,0,0,0,0,0,0,0,0,
0,0,0,0,0,0,49,0,0,0,0,38,38,38,0,52,0,0,
0,0,0,0,0,0,0,0,0,0,0,0,0,0,0,0,0,0,
0,0,0,0,0,0,0,0,0,0,43,0,0,0,0,48,0,0,
0,0,0,0,0,0,0,0,0,0,0,48,0,0,0,0,0,0,

1, 1, 1,   1, 1, 1,   1, 1, 1,   1, 1, 1,   1, 1, 1,   1, 1, 1,   1, 1, 1,   1, 1, 1,   1, 1, 1,   1, 1, 1,   1, 1, 1,   1, 1, 1,   0, 0, 1,   1, 0, 0,   0, 0, 0,   0, 0, 0,   0, 0, 0,   0, 0, 0,   
1, 1, 1,   1, 1, 1,   1, 0, 1,   1, 0, 1,   1, 1, 1,   1, 1, 1,   1, 1, 1,   1, 1, 1,   1, 1, 1,   1, 1, 1,   1, 1, 1,   1, 0, 1,   0, 0, 1,   0, 0, 0,   0, 0, 0,   0, 0, 0,   0, 0, 0,   0, 0, 0,   
1, 1, 1,   1, 1, 1,   1, 1, 1,   1, 1, 1,   1, 1, 1,   1, 1, 1,   1, 1, 1,   1, 1, 1,   1, 1, 1,   1, 1, 1,   1, 1, 1,   1, 1, 1,   1, 1, 1,   0, 0, 0,   0, 0, 0,   0, 0, 0,   0, 0, 0,   0, 0, 0,   

1, 1, 1,   1, 1, 1,   1, 1, 1,   0, 0, 0,   1, 1, 1,   1, 1, 1,   1, 1, 1,   1, 1, 1,   0, 0, 1,   1, 1, 1,   1, 1, 1,   1, 1, 1,   1, 1, 1,   1, 0, 0,   1, 0, 0,   1, 1, 1,   0, 0, 0,   0, 0, 0,   
1, 0, 1,   1, 1, 1,   1, 1, 1,   0, 0, 0,   1, 1, 1,   1, 1, 1,   1, 1, 1,   1, 1, 1,   0, 0, 1,   1, 1, 1,   1, 1, 1,   1, 1, 1,   1, 1, 1,   0, 0, 0,   0, 0, 0,   1, 0, 1,   0, 0, 0,   0, 0, 0,   
1, 1, 1,   1, 1, 1,   1, 1, 1,   0, 0, 0,   1, 1, 1,   1, 1, 1,   1, 1, 1,   1, 1, 1,   1, 1, 1,   1, 1, 1,   1, 1, 1,   1, 1, 1,   1, 1, 1,   0, 0, 0,   0, 0, 0,   1, 1, 1,   0, 0, 0,   0, 0, 0,   

1, 1, 1,   0, 0, 0,   1, 1, 1,   1, 1, 1,   1, 1, 1,   1, 1, 1,   0, 0, 0,   1, 1, 1,   0, 0, 0,   1, 1, 1,   1, 1, 1,   1, 1, 1,   1, 1, 1,   1, 1, 1,   1, 1, 1,   1, 1, 1,   1, 0, 0,   1, 0, 0,   
1, 0, 1,   0, 0, 0,   1, 1, 1,   1, 1, 1,   1, 1, 1,   1, 1, 1,   0, 0, 0,   1, 1, 1,   0, 0, 0,   1, 1, 1,   1, 1, 1,   1, 1, 1,   1, 1, 1,   1, 1, 1,   1, 1, 1,   1, 1, 1,   0, 0, 0,   0, 0, 0,   
1, 1, 1,   0, 0, 0,   1, 1, 1,   1, 1, 1,   1, 1, 1,   1, 1, 1,   0, 1, 0,   1, 1, 1,   0, 1, 0,   1, 1, 1,   1, 1, 1,   1, 1, 1,   1, 1, 1,   1, 1, 1,   1, 1, 1,   1, 1, 1,   0, 0, 0,   0, 0, 0,   

1, 1, 1,   1, 1, 1,   1, 1, 1,   0, 0, 1,   1, 1, 1,   1, 1, 1,   1, 1, 1,   1, 1, 1,   1, 1, 1,   1, 1, 1,   1, 1, 1,   1, 1, 1,   1, 1, 1,   1, 1, 1,   1, 1, 1,   1, 1, 1,   1, 1, 1,   1, 0, 0,   
1, 0, 1,   1, 1, 1,   1, 1, 1,   0, 0, 1,   1, 1, 1,   1, 1, 1,   1, 1, 1,   1, 1, 1,   1, 1, 1,   1, 1, 1,   1, 1, 1,   1, 1, 1,   0, 0, 0,   1, 1, 1,   0, 0, 0,   1, 1, 1,   1, 1, 1,   0, 0, 0,   
1, 1, 1,   1, 1, 1,   1, 1, 1,   1, 1, 1,   1, 1, 1,   1, 1, 1,   1, 1, 1,   1, 1, 1,   1, 1, 1,   1, 1, 1,   1, 1, 1,   1, 1, 1,   0, 0, 0,   1, 1, 1,   0, 0, 0,   1, 1, 1,   1, 1, 1,   0, 0, 0,   

1, 1, 1,   1, 1, 1,   1, 1, 1,   1, 1, 1,   1, 1, 1,   1, 1, 1,   1, 1, 1,   0, 0, 1,   1, 1, 1,   1, 1, 1,   1, 1, 1,   1, 1, 1,   0, 0, 0,   1, 1, 1,   0, 0, 0,   1, 1, 1,   1, 1, 1,   1, 1, 1,   
1, 1, 1,   1, 1, 1,   1, 1, 1,   1, 1, 1,   1, 1, 1,   1, 1, 1,   1, 1, 1,   0, 0, 1,   1, 1, 1,   1, 1, 1,   1, 1, 1,   1, 1, 1,   0, 2, 0,   1, 1, 1,   0, 1, 0,   1, 1, 1,   1, 1, 1,   1, 1, 1,   
1, 1, 1,   1, 1, 1,   1, 1, 1,   1, 1, 1,   1, 1, 1,   1, 1, 1,   1, 1, 1,   1, 1, 1,   1, 1, 1,   1, 1, 1,   1, 1, 1,   1, 1, 1,   1, 1, 1,   1, 1, 1,   1, 1, 1,   1, 1, 1,   1, 1, 1,   1, 1, 1,   

1, 1, 1,   1, 1, 1,   0, 0, 1,   1, 1, 1,   1, 1, 1,   1, 1, 1,   1, 1, 1,   1, 1, 1,   1, 1, 1,   1, 1, 1,   1, 1, 1,   1, 1, 1,   1, 1, 1,   1, 1, 1,   1, 1, 1,   1, 1, 1,   0, 0, 1,   1, 1, 1,   
1, 1, 1,   1, 1, 1,   0, 0, 1,   1, 1, 1,   1, 1, 1,   1, 1, 1,   1, 1, 1,   1, 1, 1,   1, 1, 1,   1, 1, 1,   1, 1, 1,   1, 1, 1,   1, 1, 1,   1, 1, 1,   1, 1, 1,   1, 1, 1,   0, 0, 1,   1, 1, 1,   
1, 1, 1,   1, 1, 1,   1, 1, 1,   1, 1, 1,   1, 1, 1,   1, 1, 1,   1, 1, 1,   1, 1, 1,   1, 1, 1,   1, 1, 1,   1, 1, 1,   1, 1, 1,   1, 1, 1,   1, 1, 1,   1, 1, 1,   1, 1, 1,   1, 1, 1,   1, 1, 1,   

0, 0, 0,   1, 1, 1,   1, 1, 1,   1, 1, 1,   1, 1, 1,   1, 1, 1,   1, 1, 1,   1, 1, 1,   1, 1, 1,   0, 0, 1,   1, 1, 1,   0, 0, 0,   0, 0, 0,   0, 0, 0,   1, 1, 1,   1, 1, 1,   1, 1, 1,   1, 1, 1,   
0, 0, 0,   1, 1, 1,   1, 1, 1,   1, 1, 1,   1, 1, 1,   1, 1, 1,   1, 1, 1,   1, 1, 1,   1, 1, 1,   0, 0, 1,   1, 1, 1,   0, 0, 0,   0, 0, 0,   0, 0, 0,   1, 1, 1,   1, 1, 1,   1, 1, 1,   1, 1, 1,   
0, 0, 0,   1, 1, 1,   1, 1, 1,   1, 1, 1,   1, 1, 1,   1, 1, 1,   1, 1, 1,   1, 1, 1,   1, 1, 1,   1, 1, 1,   1, 1, 1,   0, 1, 0,   0, 1, 0,   0, 1, 0,   1, 1, 1,   1, 1, 1,   1, 1, 1,   1, 1, 1,   

0, 0, 0,   1, 1, 1,   0, 0, 0,   1, 1, 1,   1, 1, 1,   1, 1, 1,   1, 1, 1,   1, 1, 1,   1, 1, 1,   1, 1, 1,   1, 1, 1,   1, 1, 1,   1, 1, 1,   1, 1, 1,   1, 1, 1,   1, 1, 1,   1, 1, 1,   1, 1, 1,   
0, 0, 0,   1, 1, 1,   0, 0, 0,   1, 1, 1,   1, 1, 1,   1, 1, 1,   1, 1, 1,   1, 1, 1,   1, 1, 1,   1, 1, 1,   1, 1, 1,   1, 1, 1,   1, 1, 1,   1, 1, 1,   1, 1, 1,   1, 1, 1,   1, 1, 1,   1, 1, 1,   
0, 0, 0,   1, 1, 1,   0, 0, 0,   1, 1, 1,   1, 1, 1,   1, 1, 1,   1, 1, 1,   1, 1, 1,   1, 1, 1,   1, 1, 1,   1, 1, 1,   1, 1, 1,   1, 1, 1,   1, 1, 1,   1, 1, 1,   1, 1, 1,   1, 1, 1,   1, 1, 1,   

0, 0, 0,   0, 0, 0,   0, 0, 1,   1, 1, 1,   1, 1, 1,   1, 1, 1,   0, 0, 0,   1, 1, 1,   1, 1, 1,   1, 1, 1,   1, 1, 1,   0, 0, 0,   0, 0, 0,   0, 0, 0,   1, 1, 1,   0, 0, 0,   1, 1, 1,   1, 1, 1,   
0, 0, 0,   0, 0, 0,   0, 0, 1,   1, 1, 1,   1, 1, 1,   1, 1, 1,   0, 0, 0,   1, 1, 1,   1, 1, 1,   1, 1, 1,   1, 1, 1,   0, 0, 0,   0, 0, 0,   0, 0, 0,   1, 1, 1,   0, 0, 0,   1, 1, 1,   1, 1, 1,   
0, 0, 0,   0, 0, 0,   1, 1, 1,   1, 1, 1,   1, 1, 1,   1, 1, 1,   0, 0, 0,   1, 1, 1,   1, 1, 1,   1, 1, 1,   1, 1, 1,   0, 1, 0,   0, 1, 0,   0, 1, 0,   1, 1, 1,   0, 0, 0,   1, 1, 1,   1, 1, 1,   

0, 0, 0,   0, 0, 0,   1, 1, 1,   1, 1, 1,   0, 0, 0,   1, 1, 1,   1, 0, 0,   1, 0, 0,   1, 1, 1,   1, 1, 1,   1, 1, 1,   1, 1, 1,   1, 1, 1,   1, 1, 1,   1, 1, 1,   1, 1, 1,   1, 1, 1,   1, 1, 1,   
0, 0, 0,   0, 0, 0,   1, 1, 1,   1, 1, 1,   0, 0, 0,   1, 1, 1,   0, 0, 0,   0, 0, 0,   1, 1, 1,   1, 1, 1,   1, 1, 1,   1, 1, 1,   1, 1, 1,   1, 1, 1,   1, 1, 1,   1, 1, 1,   1, 1, 1,   1, 1, 1,   
0, 0, 0,   0, 0, 0,   1, 1, 1,   1, 1, 1,   0, 0, 0,   1, 1, 1,   0, 0, 0,   0, 0, 0,   1, 1, 1,   1, 1, 1,   1, 1, 1,   1, 1, 1,   1, 1, 1,   1, 1, 1,   1, 1, 1,   1, 1, 1,   1, 1, 1,   1, 1, 1,   

0, 0, 0,   0, 0, 0,   0, 0, 1,   1, 1, 1,   0, 0, 0,   1, 0, 0,   0, 0, 0,   0, 0, 0,   1, 0, 0,   1, 1, 1,   1, 1, 1,   1, 1, 1,   1, 1, 1,   1, 1, 1,   1, 1, 1,   1, 1, 1,   0, 0, 1,   1, 1, 1,   
0, 0, 0,   0, 0, 0,   0, 0, 1,   1, 1, 1,   0, 0, 0,   0, 0, 0,   0, 0, 0,   0, 0, 0,   0, 0, 0,   1, 1, 1,   1, 0, 1,   1, 1, 1,   1, 1, 1,   1, 1, 1,   1, 1, 1,   1, 0, 1,   0, 0, 1,   1, 1, 1,   
0, 0, 0,   0, 0, 0,   1, 1, 1,   1, 1, 1,   0, 0, 0,   0, 0, 0,   0, 0, 0,   0, 0, 0,   0, 0, 0,   1, 1, 1,   1, 1, 1,   1, 1, 1,   1, 1, 1,   1, 1, 1,   1, 1, 1,   1, 1, 1,   1, 1, 1,   1, 1, 1,   

0, 0, 0,   0, 0, 0,   0, 0, 0,   1, 1, 1,   0, 0, 0,   0, 0, 0,   0, 0, 0,   0, 0, 0,   1, 0, 0,   1, 0, 0,   1, 1, 1,   1, 1, 1,   1, 1, 1,   1, 0, 1,   1, 0, 1,   1, 1, 1,   1, 1, 1,   1, 1, 1,   
0, 0, 0,   0, 0, 0,   0, 0, 0,   1, 1, 1,   0, 0, 0,   0, 0, 0,   0, 0, 0,   0, 0, 0,   0, 0, 0,   0, 0, 0,   1, 1, 1,   1, 0, 1,   1, 0, 1,   0, 0, 0,   0, 0, 0,   1, 1, 0,   1, 1, 1,   1, 1, 1,   
0, 0, 0,   0, 0, 0,   0, 0, 0,   2, 2, 2,   0, 0, 0,   0, 0, 0,   0, 0, 0,   0, 0, 0,   0, 0, 0,   0, 0, 0,   1, 1, 1,   1, 1, 1,   1, 1, 1,   0, 0, 0,   0, 0, 0,   0, 0, 0,   1, 1, 1,   1, 1, 1,   

10

5 13
orkSword
4
7 11
orkSword
4
22 3
orkSword
4
44 7
orkSword
4
44 32
orkSword
4
40 32
orkSword
4
14 22
pirate
5
30 5
orkSpear
2
33 4
orkSpear
2
17 3
orkSpear
2


2

3 11
3
7 8 9
46 1
map_1

12 4
1
5
25 34
map_4

