6 6

1,1,1,1,1,1,
1,28,28,28,28,1,
1,28,28,28,28,1,
1,28,28,28,28,1,
1,28,28,28,28,1,
1,1,28,1,1,1,

0,0,0,0,0,0,
0,0,0,0,0,0,
0,0,0,0,0,0,
0,0,0,0,0,0,
0,0,0,0,0,0,
0,0,0,0,0,0,

0, 0, 0,   0, 0, 0,   0, 0, 0,   0, 0, 0,   0, 0, 0,   0, 0, 0,   
0, 0, 0,   0, 0, 0,   0, 0, 0,   0, 0, 0,   0, 0, 0,   0, 0, 0,   
0, 0, 0,   0, 0, 0,   0, 0, 0,   0, 0, 0,   0, 0, 0,   0, 0, 0,   

0, 0, 0,   1, 1, 1,   1, 1, 1,   1, 1, 1,   1, 1, 1,   0, 0, 0,   
0, 0, 0,   1, 1, 1,   1, 1, 1,   1, 1, 1,   1, 1, 1,   0, 0, 0,   
0, 0, 0,   1, 1, 1,   1, 1, 1,   1, 1, 1,   1, 1, 1,   0, 0, 0,   

0, 0, 0,   1, 1, 1,   1, 1, 1,   1, 1, 1,   1, 1, 1,   0, 0, 0,   
0, 0, 0,   1, 1, 1,   1, 1, 1,   1, 1, 1,   1, 1, 1,   0, 0, 0,   
0, 0, 0,   1, 1, 1,   1, 1, 1,   1, 1, 1,   1, 1, 1,   0, 0, 0,   

0, 0, 0,   1, 1, 1,   1, 1, 1,   1, 1, 1,   1, 1, 1,   0, 0, 0,   
0, 0, 0,   1, 1, 1,   1, 1, 1,   1, 1, 1,   1, 1, 1,   0, 0, 0,   
0, 0, 0,   1, 1, 1,   1, 1, 1,   1, 1, 1,   1, 1, 1,   0, 0, 0,   

0, 0, 0,   1, 1, 1,   1, 1, 1,   1, 1, 1,   1, 1, 1,   0, 0, 0,   
0, 0, 0,   1, 1, 1,   1, 1, 1,   1, 1, 1,   1, 1, 1,   0, 0, 0,   
0, 0, 0,   1, 1, 1,   1, 1, 1,   1, 1, 1,   1, 1, 1,   0, 0, 0,   

0, 0, 0,   0, 0, 0,   1, 1, 1,   0, 0, 0,   0, 0, 0,   0, 0, 0,   
0, 0, 0,   0, 0, 0,   1, 1, 1,   0, 0, 0,   0, 0, 0,   0, 0, 0,   
0, 0, 0,   0, 0, 0,   2, 2, 2,   0, 0, 0,   0, 0, 0,   0, 0, 0,   

0

1

2 5
3
7 8 9
16 30
map_3